20 20
####################
#                  #
# @ @ @ ####       #
# #@#@#@#   ##@@## #
#                  #
#       @@###      #
#  !        ##@##  #
# ##@##@#   @      #
#           #  /   #
# @@@  ###  @      #
#            ##### #
#     #@#@##       #
#####  #@@@@@      #
#                  #
# # ! # ! # ! #  # #
#                  #
###@##@ ### @#@    #
#                  D
#      @#   ###### #
####################