12 12
######D#####
#   @@@@   #
#  ####    #
#    ! ! ! #
#  ####    #
#      @@@ #
##@#@#@#   #
# #@#@#@#@ #
#          #
# @@@ @@@  #
#   /      #
############